F255,2,3
C 4,   200, 66
SOtexture/WALL_S.xpm
EAtexture/WALL_E.xpm





WEtexture/WALL_W.xpm




NOtexture/WALL_N.xpm



        1111111111111111111111111
        100000000011000001N000001
        1011000001110000000000001
        1001000000000000001000001
111111110110000011100000000000001
100000000011000001110111111111111
11110111111111011100000010001
1111011111111101110101001000011111
11000000110101011100000010001
11000000000000001100000000001
100000000000000011010100100001111
110000011101010111110111100011111
11110111 1110101 101111010001
11111111 1111111 111111111111
